1000704020406005102746473
1040300202005406710070500
0000*00101001010001701017
0010500406060030056040546
1000400600305070106014744
0010110504406500010710750
0004060040402030501575070
0004050060303050022750027
0002040060400305305075400
0506054405056017563655732
6030020550604462027057003
1010110110101010011710537
0500406060206020022742740
3045050605704020033063063
3030305603305603030316012
1011011034101101447207400
3003073007571351620742453
4450474404047404746740405
0160276001717176401043712
1071101264010473036146330
3333333333307613364120701
1111111307413366776646001
1011071306343076370376372
1011111161307137307763307